011111111111111111110
012222222212222222210
013112111212111211310
012222222222222222210
012112121111121211210
012222122212221222210
011112111212111211110
000012122242221210000
111112121161121211111
222222221000122222222
111112121111121211111
000012122222221210000
011112121111121211110
012222222212222222210
012112111212111211210
013212222252222212310
011212121111121212110
012222122212221222210
012111111212111111210
012222222222222222210
011111111111111111110